mapa grafo
0010->0011
0000->0001
0011->0100
0001->0100
0100->0101
0101->1101
1010->1011
1011->1100
1100->1101
0110->1000
0111->1000
1000->1001
1101->1110
1001->1110
1110->1111